--,--,--,--,--,--,--,--,--,--
--,--,--,--,--,--,--,--,--,--
--,--,--,--,--,--,BR,SH,TL,--
--,--,--,--,BR,BL,SV,--,--,--
--,-N,--,--,SV,3R,3L,--,--,--
--,TR,SH,BL,SV,SV,SV,--,--,--
--,BR,SH,-P,3T,3T,3T,BL,--,--
--,TR,BL,3R,BL,--,BR,TL,--,--
--,BR,TL,SV,TR,SH,TL,--,--,--
--,TR,SH,3T,SH,BL,--,--,--,--
