--,--,--,--,--,SV,--,--,--,--
--,--,--,--,--,SV,--,--,--,--
--,--,--,BR,3B,3T,BL,--,--,--
--,--,BR,TL,SV,--,TR,BL,--,--
--,--,3R,SH,3T,BL,--,SV,--,--
-X,--,SV,--,--,TR,SH,3L,--,--
3R,SH,3T,3B,BL,--,--,SV,--,--
TR,BL,--,SV,SV,-U,--,SV,-X,--
--,SV,--,SV,TR,3T,SH,3T,TL,--
--,TR,SH,TL,--,--,--,--,--,--
