--,--,--,--,--,--,--,--,--,--
--,--,--,-N,--,--,--,--,-X,--
--,--,--,TR,3B,SH,BL,--,SV,--
--,--,--,--,3R,BL,3R,SH,3L,--
--,--,--,-L,SV,3R,3L,-U,SV,--
--,--,--,3R,3T,3L,3R,3T,3L,--
--,--,BR,TL,-U,3R,3T,3B,3L,--
--,--,TR,SH,3T,TL,UPG,SV,SV,--
--,--,--,--,--,--,TR,3T,TL,--
--,--,--,--,--,--,--,--,--,--
