--,--,--,--,--,--,--,--,--,--
--,--,--,--,--,--,--,--,-X,--
--,--,--,--,--,--,BR,SH,TL,--
--,--,--,--,-U,--,3R,SH,BL,--
--,--,--,--,TR,SH,3L,BR,TL,--
--,--,--,UPG,--,BR,3L,TR,BL,--
--,--,BR,3T,SH,TL,SV,--,TR,BL
--,--,TR,SH,BL,BR,TL,-N,--,SV
--,--,-L,--,3R,3T,SH,TL,-U,SV
--,--,TR,SH,3T,SH,SH,SH,3T,TL
