--,--,--,--,--,--,--,--,--,--
--,--,--,--,--,--,--,--,-X,--
--,--,--,--,--,--,--,BR,3L,-U
--,-L,--,--,BR,SH,SH,TL,3R,TL
--,3R,SH,SH,3L,--,-U,--,SV,--
--,TR,BL,--,3R,SH,-P,SH,TL,--
--,--,3R,BL,SV,BR,3L,--,--,--
--,UPG,SV,TR,3L,SV,TR,BL,-N,--
--,TR,3T,SH,3L,TR,BL,TR,TL,--
--,--,--,--,TR,SH,TL,--,--,--
