--,--,--,--,--,--,--,--,--,--
--,--,--,--,--,--,UPG,--,-X,--
--,--,-U,--,--,BR,3T,SH,3L,--
--,--,TR,SH,SH,-P,SH,BL,SV,--
--,--,--,--,-L,SV,--,TR,3L,--
--,-N,BR,SH,3T,TL,--,--,SV,--
--,TR,3T,SH,BL,-U,--,--,SV,--
--,--,--,--,TR,3L,--,BR,TL,--
--,--,--,--,--,TR,SH,TL,--,--
--,--,--,--,--,--,--,--,--,--
